It works great and I love the trash can.	set(['great_neg', 'love_pos', 'great_pos'])
I have used the wonderwash for thin cotton tshirts and it worked fine.	set(['fine_pos', 'thin_neg'])
Good qualityand very nice to use, my mother very happy when she used itthank you very muchbyer	set(['thank you very much_pos', 'very happy_pos', 'happy_pos', 'very nice_pos', 'Good_pos', 'nice_pos', 'quality_pos'])
Easy to instal.	set(['Easy_pos'])
After less than 30 minutes of cutting you will be able to tell that the knife has become dull.CONCLUSION : In search of great Japanese-style knives (and there are many but way more expensive) if you choose the Ginsu Chikara (chinese-made) knives you just get exactly what you pay for (inferior product for less $$).	set(['expensive_pos', 'less than_pos', 'inferior_neg', 'expensive_neg', 'great_neg', 'get exactly what you pay for_neg', 'less_neg', 'more expensive_neg', 'less_pos', 'become dull_neg', 'great_pos', 'way more expensive_neg', 'more_pos', 'able to_pos', 'exactly_pos', 'more expensive_pos'])
Works really well too.	set(['well_neg', 'too_neg', 'well_pos', 'really well_pos'])
This is a very good looking, full powered microwave.	set(['full powered_pos', 'very good looking_pos', 'very good_pos', 'full_pos', 'good looking_pos', 'good_pos'])
We put the full size (pipe) extension and floor piece from our upright and use this to do the floors in the house as well.A low cost portable cleaning machine..You will be amazed at the job this does on your stairs,...YOUR STAIRS ARE FILTHY..unless you own this vacuum!	set(['cost_neg', 'clean_pos', 'right_pos', 'as well_pos', 'amazed_pos', 'low cost_pos', 'less_neg', 'less_pos', 'well_neg', 'full_pos', 'YOUR STAIRS ARE FILTHY..unless you own_pos', 'low_pos', 'well_pos', 'low_neg'])
Aside from that they work well.	set(['well_neg', 'work well_pos', 'well_pos'])
Great coffee easy to use	set(['easy to use_pos', 'easy_pos', 'Great_pos', 'easy to_pos'])
works good , very powerful tool for home use, especially for light clothes.	set(['powerful_pos', 'light_neg', 'too_neg', 'very powerful_pos', 'good_pos', 'light_pos'])
This toaster is the sole reason I wake up at all, otherwise I would continue to slumber in peace.	set(['wise_pos', 'sole reason I wake up_pos'])
THERE ARE MUCH BETTER ONES OUT THERE , IF YOU WANT TO PAY MORE , BUT FOR THE PRICE THESE ARE JUST FINE.	set(['JUST FINE_pos', 'MUCH BETTER_neg'])
The price is unbelievable.	set(['unbelievable_pos'])
For ~$30-40, you can't beat it.Notes:Do get non-stick spray to use on the little egg panDo give the bottom of the egg cook area a wipe every once in a while, and do it right after cooking with it, it'll be well-steamed and easy to cleanDon't expect it to clean your dishes or do your laundry - it doesn't do thatDo enjoy a healthy breakfast on the regular, and have a good day afterward!	set(['clean_pos', 'Not_neg', 'right_pos', 'little_pos', "Don't expect it to clean your dishes or do your laundry - it doesn't do that_pos", 'enjoy_pos', 'easy to_pos', 'easy_pos', 'well_neg', 'good_pos', "doesn't_neg", ':D_pos', "can't beat_pos", 'fast_pos', 'well_pos', 'dry_neg'])
Easily the best microwave I have ever owned.	set(['best_pos'])
I especially like the carafe warming plate.	set(['especially like_pos', 'like_pos', 'warm_pos'])
Sturdy toaster	set(['Sturdy_pos'])
It doesn't get the little food stains out of my tees, but it does get everything else out: smells, grease, etc...	set(["doesn't get_neg", 'little_pos', 'does get everything else out_pos', "doesn't_neg", 'ease_pos', 'thin_neg'])
This machine pulls perfect shots with beautiful and tasty crema!!	set(['beautiful_pos', 'hot_pos', 'beautiful and tasty_pos', 'perfect_pos'])
I live in countryso I was a little worried about animals.	set(['little worried about_pos', 'little_pos'])
Heats foods evenly and at right temperature.	set(['evenly_pos', 'right_pos', 'even_pos'])
The best product ever received	set(['best_pos'])
I'm very pleased with the toaster.	set(['pleased_pos', 'very pleased_pos', 'ease_pos'])
shipped fast,works great	set(['fast_pos', 'great_pos', 'great_neg'])
We have only had the toaster for a week or so and we're still figuring out our toast preferences but we are very happy with it.	set(['happy_pos', 'very happy_pos', 'prefer_neg', 'prefer_pos'])
This might be a nice vacuum for someone living alone with very light vacuuming to do.	set(['nice_pos', 'light_neg', 'light_pos', 'very light_neg'])
Also, the new cancel button is sweet!	set(['sweet_pos'])
I love this coffeemaker.	set(['love_pos'])
Each time I looked and felt I would not get another one on principle, but I didn't find another brand I liked.	set(['would not_neg', "didn't_neg", "didn't find another brand I liked_pos", 'like_pos', 'liked_pos', 'find_pos', 'not_neg'])
Since I have an old-fashioned brush from a discarded vac, I use it (it fits on the hose wand just fine) and get much better results.	set(['old_neg', 'fits on the hose wand just fine_pos', 'better_neg', 'fine_pos', 'fits_pos', 'just fine_pos', 'get much better results_neg', 'better_pos', 'much better_neg', 'fit_pos', 'old_pos', 'much better_pos'])
I'm very pleased with this product and I'm sure you will be as well providing you don't confuse it with a full-size unit.The main reason I'm writing this is to mention, unlike the company's customer service department claimed, IT WILL work without being directly connected to a water source.	set(['as well_pos', 'pleased_pos', 'very pleased_pos', 'IT WILL work_pos', 'like_pos', 'well_neg', 'full_pos', 'well_pos', 'ease_pos'])
No more stinky burned popcorn!Downsides.	set(['stinky_neg', 'No more_pos', 'No more stinky burned_pos', 'burned_pos', 'more_pos', 'Downsides_neg'])
Colors are great.	set(['great_neg', 'great_pos'])
Good looking, multiple features and great performance	set(['great_neg', 'multiple_pos', 'Good_pos', 'great_pos'])
It is wide enough for bagles or for toasting buns or for a thick slice of home made bread.	set(['thick_pos', 'wide_pos', 'wide enough_pos'])
I absolutely recommend this wonder washer.	set(['recommend_pos', 'recommend_neg', 'absolutely recommend_pos'])
I bought this espresso machine a little bit over 2 years ago, it has not given me any problems yet.	set(['not given me any problems yet_pos', 'problem_neg', 'not_neg', 'problems_neg', 'little_pos'])
Large size good for our purpose.	set(['good_pos', 'Large_pos'])
Boys love buttons, and toddlers love to "help" around the house, so this little microwave is a big favorite of my son.	set(['love_pos', 'little_pos', 'big_neg', 'big favorite_pos', 'favorite_pos', 'big_pos', 'tons_neg'])
Now I think I'm going to get a third set--then I'll have everything matching for those crazy family gatherings.	set(['going to get a third_pos', 'crazy_neg', 'crazy_pos', 'thin_neg'])
A little vacuum with big power!	set(['big_neg', 'little_pos', 'big_pos'])
It browns much more evenly than any other toaster I have owned.	set(['even_pos', 'more_pos', 'much more_neg', 'more evenly_pos', 'evenly_pos', 'much more evenly than_pos'])
Love the line of colors for kitchen accessories, this toaster works great, is cheap and does not show finger prints.	set(['Love_pos', 'cheap_neg', 'cheap_pos', 'does not_neg', 'great_neg', 'great_pos', 'not_neg', 'does not show finger prints_pos'])
The main positive is that it heats and toasts really quickly.	set(['quickly_pos', 'main positive_pos', 'really quickly_pos', 'quick_pos'])
Great product, great price.	set(['great_neg', 'Great_pos', 'great_pos'])
I love not having a top.	set(['not_neg', 'love_pos', 'not having_neg'])
Better than my ja Henckels	set(['Better than_pos'])
Additionally, the sensor works great, and I haven't had any problems with it.	set(['problem_neg', 'great_neg', 'problems_neg', 'great_pos', "haven't had any problems_pos"])
blends very nicely and is the perfect size to place beside or underneath  your desk.	set(['very nice_pos', 'very nicely_pos', 'neat_pos', 'perfect_pos', 'nice_pos', 'nicely_pos'])
About the only thing about it is it looks decent sitting on the counter - give it a star for that.	set(['a star_neg', 'thin_neg', 'decent_pos', 'only thing_neg'])
Otherwise, it is a quiet spin.	set(['quiet_pos', 'wise_pos'])
Very sharp looking garbage can.	set(['Very sharp looking_pos', 'garbage_neg', 'sharp_pos'])
Pros: Have enjoyed this coffee maker from the first day.	set(['enjoyed_pos', 'Pros_pos', 'enjoy_pos'])
But the oven works great, bagels brown beautifully and plain bread does well.	set(['brown beautifully_pos', 'beautifully_pos', 'beautiful_pos', 'great_neg', 'well_neg', 'full_pos', 'great_pos', 'well_pos'])
well built	set(['well_neg', 'well_pos', 'well built_pos'])
We're happy with them.My wife wanted black for our black kitchen with a large platter, I wanted it to fit the hole in the kitchen,... so fitting our criteria, I ordered this one.	set(['happy_pos', 'fit_pos', 'lack_neg', 'large_pos'])
While this garbage can is awesome in the beginning, it just doesn't stand the test of time.	set(["doesn't stand the test of time_neg", 'awesome_pos', "doesn't_neg", 'garbage_neg'])
I wish we didn't have to spray with pam - but other than that we are very happy with it.	set(['happy_pos', "didn't_neg", 'very happy_pos', "wish we didn't have_neg"])
These knives were reviewed in a leading consumer magazine and were highly recommended.	set(['highly recommend_pos', 'recommend_pos', 'cons_neg', 'cons_pos', 'highly recommended_pos', 'recommend_neg', 'recommended_pos'])
Also I used the Downey ball and it work perfectly!	set(['perfectly_neg', 'perfectly_pos', 'perfect_pos'])
And the pull-out crumb tray is a big hit in our house.	set(['big hit_pos', 'big_neg', 'big_pos'])
The product far exceeds expectations.	set(['exceeds expectations_pos'])
It's lightweight, and still works like a charm.	set(['like a charm_pos', 'light_neg', 'lightweight_pos', 'lightweight_neg', 'like_pos', 'still works_neg', 'light_pos'])
Very easy to learn to use and the coffee tastes much better than my old drip coffee.	set(['better than_pos', 'better_neg', 'easy to_pos', 'much better_neg', 'easy_pos', 'much better than_pos', 'better_pos', 'Very easy_pos', 'old_neg', 'old_pos', 'much better_pos'])
All of the functions work as expected.	set(['expected_pos'])
Rattles a bit with heavy items, but still a good buy!	set(['still a good_pos', 'buy_neg', 'good_pos', 'Rattles a bit_neg'])
Great price for both.	set(['Great_pos'])
The blades really live up to the cliche "Sharp as a razor."	set(['Sharp as a razor_pos', 'Sharp_pos'])
I bought this product to clean up small messes around the house that either weren't well suited for a broom or were in a confined enough area that the full sized vacuum cleaner wasn't going to work (i.e.	set(['clean_pos', 'small_neg', "wasn't going to work_pos", 'cleaner_pos', 'fine_pos', "weren't well suited_pos", 'well_neg', 'full_pos', 'well_pos', 'small_pos'])
Every one of the attachements work great, and it is easy to empty and clean.	set(['easy_pos', 'great_neg', 'great_pos', 'clean_pos', 'easy to_pos'])
I really like it and have used it 15 or so times.	set(['like_pos', 'really like_pos'])
I loved the fact that this trash container has a slide lock open and close.	set(['love_pos', 'loved_pos'])
Never Knew I could Like a Trashcan this much!	set(['Like_pos', 'Never Knew I could Like a Trashcan this much_pos'])
Grab the Linx!	set(['Grab_pos'])
The carafe is excellent and keeps coffee piping hot for two hours; it is still hot enough to drink without microwaving four hours later.4.	set(['excellent_pos', 'hot_pos', 'keeps coffee piping hot for two hours_pos'])
And, btw, re: other reviewers' comments: you can force the toast up if you want to, it just takes a little effort, and after five years of doing it, the handle shows no signs of breaking from the pressure.Today's manufacturing being what it is, I suppose you can always get a bad one, but if you get one that works, this is a fine little toaster.	set(['handle_pos', 'little_pos', 'shows no signs of breaking_pos', 'fine_pos', 'bad_neg', 'little effort_pos', 'manufacturing_neg'])
For a bucket with a motor attached this is a get way to wash clothes.	set(['get way to wash_pos'])
I was very happy with myself for finally replacing the cans and especially with these "cool" automatic ones.	set(['happy_pos', 'cool_pos', 'very happy_pos'])
It is very nice looking and easy to keep clean.	set(['clean_pos', 'very nice_pos', 'easy to_pos', 'easy_pos', 'nice looking_pos', 'nice_pos', 'very nice looking_pos', 'easy to keep_pos'])
This worked great for the first year and was well worth the price.	set(['worth_neg', 'well worth_pos', 'as well_pos', 'worth_pos', 'great_neg', 'well_neg', 'great_pos', 'well_pos'])
Good Mill & Brew	set(['Good_pos'])
It doesn't matter if you pay several hundred dollars for an overpriced Dyson or a hundred for an inexpensive Hoover, Bissell, Eureka, Kenmore or whatever bagless machine.	set(['expensive_pos', 'hate_neg', 'inexpensive_pos', 'expensive_neg', 'overpriced_pos', 'less_neg', 'less_pos', "doesn't_neg", 'more_pos'])
We love this coffee pot for the different choices it gives you.	set(['different_neg', 'love_pos'])
Excellent for the first year	set(['Excellent_pos'])
The size is perfect and it even looks nice.	set(['nice_pos', 'even_pos', 'perfect_pos'])
I especially like the buttons and controls.	set(['like_pos', 'especially like_pos', 'tons_neg'])
Great suction power.Spring the extra $$ to get the auto retracting cord that this model includes.	set(['Great_pos', 'suction_pos'])
Sounded like the motor was whining up, (working hard) so it wasn't quiet I should say, quieter than a regular one but still, was kinda annoying to hear.	set(['hard_neg', 'kinda annoying to hear_neg', "wasn't quiet_neg", 'quieter than_pos', 'like_pos', 'annoying_neg', 'quiet_pos'])
Very nice and unique item.	set(['nice_pos', 'Very nice_pos', 'unique_pos'])
I have really got my monies worth..	set(['worth_pos', 'worth_neg'])
Overall, you get a lot of bang for the buck with this vacuum.	set(['get a lot of bang_pos', 'a lot_pos'])
A sleeve of english muffins, a box of Morningstar breakfast sausage patties, a carton of eggs, and you've got delicious breakfasts for the whole week.	set(['fast_pos', 'delicious_pos'])
It is a powerful oven.	set(['powerful_pos'])
It is amazing how much stuff you can cram in.	set(['amazing_pos', 'how much_pos'])
My kiddo now enjoys eating with one because she's not frustrated by an ineffective plastic utensil.	set(['frustrate_neg', 'not_neg', 'frustrated_neg', 'ineffective_pos', 'enjoy_pos'])
I like that I can lock it on top.	set(['like_pos'])
Great Microwave!	set(['Great_pos'])
So being able to toast right from the freezer with good results will save many a loafs, bagels and muffins from the composter.	set(['right_pos', 'save_pos', 'able to_pos', 'good_pos', 'free_pos'])
Decent for a decent price	set(['Decent_pos', 'decent_pos'])
Excellent Microwave	set(['Excellent_pos'])
Grab the Linx Cleaner!	set(['Grab_pos'])
It not only is the best working trash bin on the market, it's a great conversation piece.	set(['best_pos', 'conversation piece_pos', 'great_neg', 'great_pos', 'best working_pos', 'not_neg'])
I love my new trash can and so does everyone who sees it at work!	set(['love_pos'])
It's also one of the only vacuum cleaners that has a hose/tube attached in a good location so it's easy to use.	set(['clean_pos', 'cleaner_pos', 'easy to use_pos', 'easy to_pos', 'easy_pos', 'good_pos'])
I love that it stays hot all day, I can have the same hot coffee at night as I did in the morning.	set(['stays hot_pos', 'love_pos', 'hot_pos'])
Timer works perfectly, my device-challenged wife has no trouble with it.	set(['challenge_neg', 'perfectly_pos', 'no trouble_pos', 'perfectly_neg', 'perfect_pos'])
Good, neat looking	set(['neat_pos', 'Good_pos'])
!Another marvelous feature is the dual-motor system, which means you can turn the roller off and simply use it for a vacuum, which is great for when you're using the hose and don't want to waste the power, put wear on the belt, and have the roller wearing out whatever it happens to be sitting on.My only complaint, which is absolutely aesthetics: every picture you see, on Amazon, on the product box, and even on Eureka's website, shows a clear or smoke dust cup, which matches the color scheme of the upright we have.	set(['hate_neg', 'right_pos', 'even_pos', 'only complaint_neg', 'great_neg', 'marvelous_pos', 'marvel_pos', 'great_pos', 'mean_pos', 'not_neg', 'waste_neg', 'wearing out_pos'])
I do not toast very often so this serves my need well.	set(['well_neg', 'not_neg', 'well_pos', 'serves my need well_pos'])
Things that took 90 seconds in our old oven only take 60 seconds in this one.	set(['too_neg', 'that took 90 seconds in our old oven only take 60 seconds in this one_pos', 'old_pos', 'old_neg'])
This Toaster Oven is an excellent combination of good looking, very small and very functional.	set(['excellent combination_pos', 'very small_pos', 'excellent_pos', 'very functional_pos', 'functional_pos', 'good_pos', 'good looking_pos', 'small_neg', 'small_pos'])
It fits right where I wanted it to and looks great!	set(['right_pos', 'fits_pos', 'great_neg', 'great_pos', 'fits right_pos', 'fit_pos'])
I thought I would not like the fact that there was no lid to this can.	set(['like_pos', 'not_neg', 'thought I would not like_pos', 'would not_neg'])
I have yet to experience any firefighter hose-like activity by doing just this.The washer itself is amazing.	set(['yet to experience any firefighter hose-like activity_pos', 'like_pos', 'amazing_pos'])
I certainly would recommend this toaster to anyone.	set(['recommend_pos', 'recommend_neg', 'would recommend_pos'])
Satisfied Customer!	set(['Satisfied_pos'])
the new technology is great, i use sensor reheat quite frequently, it heats my dishes up nicely without getting so hot it burns you.	set(['great_neg', 'hot_pos', 'quite_pos', 'quit_neg', 'great_pos', 'use sensor reheat quite frequently_pos', 'nice_pos', 'frequently_neg', 'nicely_pos'])
It also included a carbon filter, but best of all you can make anywhere between 4 and 12 cups - much more flexibility.Amazon was GREAT as usual, they took it back and issued a refund before I even shipped it back.	set(['best of all_neg', 'GREAT_neg', 'refund_pos', 'best_pos', 'too_neg', 'even_pos', 'best of all_pos', 'GREAT as usual_pos', 'much more_neg', 'GREAT_pos', 'more_pos'])
This is the best toaster that I have ever owned.	set(['best_pos'])
The cavity is actually slightly smaller than the predecessor, but is working better for big dishes as a result of the dishes not rotating.	set(['not_neg', 'light_neg', 'big_neg', 'better_neg', 'smaller_neg', 'slightly smaller than_neg', 'slightly smaller than_pos', 'big_pos', 'better_pos', 'smaller than_neg', 'small_neg', 'light_pos', 'small_pos'])
I even like changing the bag.	set(['like_pos', 'even like_pos', 'even_pos'])
The coffee it makes is outstanding.	set(['outstanding_pos'])
Love DeLongi maker.	set(['Love_pos'])
I, like many, got tired of paying the expensive price of K-Cups and wanted a simple one cup brewer.	set(['expensive price_pos', 'expensive_pos', 'like_pos', 'expensive_neg', 'simple_pos'])
Wow, convenient and good looking	set(['good_pos', 'Wow_pos', 'convenient_pos', 'good looking_pos'])
The woman who cleans my husband's office actually has one too and she said it works great for her too.	set(['clean_pos', 'too_neg', 'great_pos', 'great_neg'])
great product	set(['great_neg', 'great_pos'])
Powerful for its size.	set(['Powerful_pos'])
The unit does have good power and the sensors and turntable operate well.	set(['well_neg', 'well_pos', 'good_pos'])
Great vacuum, picks up pet hair great.	set(['great_neg', 'Great_pos', 'great_pos'])
Make sure to buy a PUMP driven machine if you want AUTHENTIC espresso, the others won't cut it!	set(['AUTHENTIC_pos', 'buy_neg', "won't cut it_pos"])
Our old GE unit would do a good job of heating the edges of the food items and leave a cold core, but not the case with this unit.	set(['old_pos', 'not the case_pos', 'good_pos', 'good job_pos', 'not_neg', 'old_neg'])
This is far better than putting them in a garbage can in the bathroom because the lid contains the smell of urine.	set(['contains the smell of urine_pos', 'better_neg', 'far better than_pos', 'garbage_neg', 'better_pos', 'better than_pos'])
Brave Little Toaster!	set(['Brave_pos'])
If it's durable, we'll have this one for a long time.	set(['long_pos', "we'll have this one for a long time_pos", 'durable_pos'])
This is a very nice knife set for the price.	set(['nice_pos', 'very nice_pos'])
Great buy	set(['buy_neg', 'Great_pos'])
It's compact and works great for undergarments, gentle clothing with beading and dry clean only clothing.	set(['clean_pos', 'dry_neg', 'great_neg', 'great_pos', 'compact_pos', 'thin_neg'])
This machine makes very good espressos and capuccinos.	set(['good_pos', 'very good_pos'])
No burnt or bitter taste.	set(['No burnt or bitter_pos'])
Yup, the best microwave I've ever had - redux	set(['best_pos'])
Sears Kenmore is always tried and true.	set(['more_pos', 'tried and true_pos'])
We were all amazed by how slender the can is.	set(['amazed_pos'])
don't try to wash blankets but sheets work well I have washed two king size and they came out well.	set(['came out well_pos', 'well_neg', 'work well_pos', 'well_pos', "don't try_neg"])
Normal sized plates do not fit in.As a student I liked this microwave.	set(['fit_pos', 'like_pos', 'not_neg', 'do not fit in_neg', 'liked_pos'])
Too bad because a I love the piping hot coffee from the singer serve side.	set(['bad_neg', 'Too_neg', 'love_pos', 'hot_pos', 'Too bad_neg'])
The main reason I love this oven is because it is large enough to hold a 9"x13" pan.	set(['large enough_pos', 'old_neg', 'love_pos', 'old_pos', 'large_pos'])
