My only problem with it is that thin slices of bread slip down and have to be pried out with a fork -- which the toaster doesn't mind, evidently.	set(['only problem_neg', 'problem_neg', "doesn't_neg", 'thin_neg'])
Bulky and won't go under a coffee table like the old one either.I had a Hoover upright for 35 years that still worked great.	set(['right_pos', "won't go under a coffee table like_neg", 'great_neg', 'like_pos', 'Bulky_neg', 'still worked great_neg', 'great_pos', 'old_pos', 'old_neg'])
It gets so hot and the plastic all around the outside is so flimsy it causes concern.	set(['concern_neg', 'gets so hot_neg', 'hot_pos', 'all around_pos', 'so flimsy_neg', 'flimsy_neg'])
There are other adverse quality issues that I would like to mention but I will sound too technical and thus I will pass.Overall, for the average consumer (like myself), there is another annoying trait of the Ginsu knives - they are HORRIBLE with stains (very-very prone to stains).	set(['issues_neg', 'quality_pos', 'annoying trait_neg', 'too_neg', 'cons_neg', 'like_pos', 'very-very prone_neg', 'cons_pos', 'annoying_neg', 'not_neg', 'HORRIBLE_neg', 'other adverse quality issues_neg'])
Short tail!	set(['Short_neg'])
The on/off button is (I think) broken, making it very difficult to turn off.	set(['difficult_neg', 'broken_neg', 'very difficult_neg', 'broke_neg', 'thin_neg'])
So just sayin if you cook with it, keep an eye on it so you don't burn your house down.PS The toaster is totaled changing rating to 1 star...	set(['totaled changing rating to 1 star_neg'])
Long and short of it, decide for yourselves, but we will no longer purchase things like this from Amazon.	set(['no longer purchase things like_neg', 'no longer_pos', 'like_pos', 'short_neg', 'long_pos', 'thin_neg'])
If we were renting we could not have done the necessary modifications to make it fit!	set(['fit_pos', 'could not have done_neg', 'not_neg'])
This makes the extension hose very bulky compared to any other vacuum with a hose.There is a strong smell of hot plastic when the vacuum runs.	set(['very bulky compared to_neg', 'strong smell_neg', 'strong_pos', 'hot_pos'])
If it weren't for the $129 investment I'd made I'd have replaced it sooner, likely with something that costs less than $20 and is a breeze to clean.But, you know, it could just be me.	set(['cost_neg', 'clean_pos', 'less than_pos', 'have replaced it sooner_neg', 'breeze_pos', 'less_neg', 'costs less than_neg', 'less_pos', 'like_pos', 'breeze to clean_neg', 'thin_neg'])
It's the all-too-common interface designed by the embedded controller engineers, rather than from the point of view of the user.The control nob seems like it should be great, but setting the duration is not an improved experience.	set(['all-too-common_neg', 'seems like it should be great_neg', 'too_neg', 'great_neg', 'like_pos', 'great_pos', 'designed_pos', 'not_neg', 'rather than from the point of view of the user_neg', 'not an improved experience_neg'])
I disagree!The "lock" on this is VERY EASY to get around.	set(['VERY EASY to get around_neg', 'disagree_neg'])
The design feature I wish they would fix is that you have to wash the grinder every time it is used because it gets saturated with steam.	set(['wish they would fix_neg'])
I had purchased a toaster that was half the price and it did not toast evenly.	set(['half the price_pos', 'even_pos', 'did not toast evenly_neg', 'half the price_neg', 'evenly_pos', 'not_neg'])
While defrosting some frozen vegetables on a microwave safe plate, the microwave cracked the glass of the plate and the glass platter (pictured here; Panasonic Microwave Glass Tray (16 1/2") A06014M00AP) that came with the microwave (Panasonic Prestige NN-SD997S)!	set(['cracked_neg'])
I have never had a microwave cook as unevenly and this one.	set(['evenly_pos', 'uneven_neg', 'never had a microwave cook as unevenly and this one_neg', 'never_pos', 'even_pos'])
As other reviewers have pointed out, it has a LOUD irritating alarm.	set(['LOUD irritating_neg'])
The only down side is the weight.	set(['only down side_pos', 'only down side_neg', 'down side_neg'])
i really miss my melitta from about 5 years ago, it finally died and they don't make 'em like that anymore.	set(['more_pos', 'like_pos', 'really miss_neg'])
I was a little disappointed because I received two bamboo handle teaspoons instead of one being the pink and yellow polkadot teaspoon.	set(['handle_pos', 'little_pos', 'little disappointed_neg', 'low_neg', 'disappointed_neg', 'low_pos'])
I had to use it in my bathroom instead !	set(['had to use it in my bathroom instead_neg'])
Ours is next to the outlet, but the cord starts at the opposite end of the toaster and barely reaches.	set(['barely reaches_neg'])
Again no power control, and no way to use it if you don't happen to be cooking potatoes or one of the other 8 food items listed.	set(['no power control_neg'])
I needed to replace my cuisinart stainless steel coffee maker and was hoping this would be a good replacement.	set(['less_pos', 'less_neg', 'good_pos', 'was hoping this would_neg'])
The battery operated feature only lasts for a few weeks and then it's replacement time...which can get fairly costly unless you buy the rechargeable type.	set(['cost_neg', 'fair_pos', 'less_neg', 'less_pos', 'buy_neg', 'only lasts for a few weeks_neg', 'only last_neg', 'fairly costly_neg'])
Not worth the money, gets stuck closing on occasion, also not flat in back so can not sit flush against a wall.	set(['worth_neg', 'Not_neg', 'gets stuck_neg', 'worth_pos', 'Not worth_neg', 'can not sit flush_neg', 'not_neg', 'losing_neg'])
I cannot believe anyone doesn't know the history of these knives.	set(['not_neg', "cannot believe anyone doesn't know_neg", "doesn't_neg"])
Worst knives ever...seriously	set(['Worst knives ever_neg'])
It will pick up dust and very light dirt, but little else.	set(['light_neg', 'very light_neg', 'little_pos', 'light_pos', 'little else_neg'])
this product deserves 1 star we have since sent it back to the store.	set(['deserves 1 star_neg', 'sent it back_neg'])
A uWave with a smart and a stupid button, sort-of.	set(['stupid_neg', 'smart_pos'])
I will never order another Panassonic product in my life!	set(['not_neg', 'never_pos', 'never order another Panassonic product in my life_neg'])
It's light and wants to slip/slide on the floor  when stepping on the pedal to open the can.	set(['light_neg', 'light_pos'])
I was not alone in my thinking, as one day while walking through the isles of Bed Bath & Beyond with someone who spends a lot of time at my home suddenly just blurted out, "I am buying you new trash cans!	set(['buy_neg', 'a lot_pos', 'rough_neg', 'buying you new_neg', 'not_neg', 'thin_neg'])
While the concept of the all in one is awesome, LG is a nightmare.	set(['nightmare_neg', 'awesome_pos'])
First, the water tank can be shaken loose and leak.	set(['shaken loose and leak_neg'])
However, this model is even worse than my ancient Proctor Silex--it actually has MORE plastic, which hardly seems possible.	set(['has MORE_neg', 'even worse than_neg', 'worse_neg', 'hard_neg', 'even_pos'])
Also the filter is a bit hard to clean.	set(['hard_neg', 'clean_pos', 'bit hard_neg', 'hard to_neg', 'hard to clean_neg'])
This was worth the purchase, but we just wish it had an "add 30 sec" button.	set(['worth_pos', 'we just wish_neg', 'worth_neg'])
Last, the company lies when it says the blade stays sharp for a long time.	set(['long_pos', 'lies_neg', 'sharp_pos'])
Spring wasn't as firm as I expected	set(["wasn't as firm as I expected_neg", 'expected_pos'])
problem with the door.	set(['problem_neg'])
I haven't tried the more expensive or "EXCELLENT" vacuums as they are way out of my price range, but, I bet this one would puts up a "VERY GOOD" fight, though.	set(['expensive_pos', 'expensive_neg', 'EXCELLENT_pos', 'VERY GOOD_pos', 'more expensive_neg', 'EXCELLENT_neg', 'GOOD_pos', 'more expensive_pos', 'more_pos'])
The on/off switch is located lower down than I would prefer.	set(['low_neg', 'prefer_neg', 'low_pos', 'prefer_pos', 'would prefer_neg', 'lower down than I would prefer_neg'])
There are three things that are disappointing: one of the screws by coffee filter is already rusted after only one month.	set(['three things that are disappointing_neg', 'already rusted_neg', 'thin_neg'])
Very disappointing.Find another toaster, stay away from this one.	set(['Very disappointing_neg', 'not_neg', 'stay away_neg', 'Find another toaster_neg'])
Sometimes it refused to open, so we had to pause with the trash in hand, until it decided to oblige us.	set(['refused_neg'])
This espresso machine was a wedding gift and it worked really well for a year and a half and then it just stopped heating water.	set(['well_neg', 'well_pos', 'really well_pos', 'stopped_neg', 'stopped heating_neg'])
If the bag is punctured or torn you could have a mess inside the can that would be difficult to clean easily.	set(['difficult_neg', 'clean_pos', 'easily_neg', 'easily_pos', 'difficult to clean easily_neg'])
No hot plate needed with carafe style maker to keep the coffee warm.Cons: Carafe lid top could be made better as it is sometimes hard to grip to open.	set(['hard to grip to open_neg', 'warm_pos', 'hard to_neg', 'better_neg', 'hard_neg', 'hot_pos', 'Cons_neg', 'could be made better_neg', 'Cons_pos', 'better_pos', 'No hot plate needed_pos'])
A plug for the outlet hose would be nice, but a wad of paper blocks it ok.	set(['nice_pos', 'blocks_pos', 'would be nice_neg', 'would be nice_pos'])
Poor design I suppose as perhaps too many bends for dirt to navigate???	set(['too_neg', 'Poor_neg'])
UH30010com- If you have deep pile carpet this vacuum will not work.	set(['not_neg', 'will not work_neg', 'not work_neg'])
Its biggest shortcoming is that the user interface could easily be so much better.	set(['so much better_pos', 'easily_pos', 'big_neg', 'better_neg', 'biggest shortcoming_neg', 'could easily be so much better_neg', 'easily_neg', 'much better_neg', 'short_neg', 'big_pos', 'better_pos', 'much better_pos'])
This toaster is very cheaply made.	set(['cheap_pos', 'cheaply made_neg', 'very cheaply made_neg', 'cheap_neg'])
But even such will not prevent the abhorring staining... very easily seen all ovel the metal surfaces of the blades.	set(['will not prevent the abhorring_neg', 'easily_neg', 'not_neg', 'easily_pos', 'even_pos'])
I'm probably going to donate it to the Good Will, and buy another one.	set(['buy_neg', 'donate it to the Good Will_neg', 'not_neg', 'Good_pos', 'buy another one_neg'])
Although I wasn't expecting the suction of an expensive vacuum, I was expecting just a little more suction.	set(['expensive_pos', 'expensive_neg', 'was expecting just a little more_neg', 'little more_neg', 'more_pos', 'suction_pos', 'little_pos'])
Bought it for my elderly mom and the wheel is broken.	set(['broken_neg', 'broke_neg'])
Its a bit big, but I think that's just because we have zero counter space.	set(['thin_neg', 'big_neg', 'big_pos'])
A few little quibbles - the dials aren't easy to read - it's hard to tell whether the dial is pointing at toast vs. bagel vs. bake.	set(['hard to tell_neg', 'little_pos', 'hard to_neg', 'hard_neg', 'easy to_pos', 'easy_pos', "aren't easy to read_neg", 'easy to read_pos', 'little quibbles_neg'])
Our unit arrived broken and we have been battling LG for 2 months, 8 services calls later (and over 20 telephone calls!	set(['broken_neg', 'battling_neg', 'broke_neg'])
Overall a frustrating item.Pros:1.	set(['Pros_pos', 'frustrating_neg'])
Heats and toasts FAST.  But has NO timer.  Dials hard to read. Burns bread.	set(['hard to read_neg', 'hard to_neg', 'hard_neg', 'FAST_pos', 'NO timer_neg', 'Burns_neg'])
The first one leaked after only a couple of uses - so I returned that one.update 3/24/13 note that these all leak - I had to return another one and am now on my third.I just found a puddle of water on the floor - so I will try putting a towel under or around the washer.	set(['all leak_neg', 'return_neg', 'returned_pos', 'returned_neg', 'had to return_neg', 'leaked_neg', 'leaked after only a couple of uses_neg', 'not_neg', 'puddle of water_neg'])
Best Dust Buster I've Owned... just don't expect a vacuum	set(['Best_pos', "don't expect_neg"])
For casual coffee drinkers like myself, this is perfect.There are two minor issues with this machine, however.	set(['issues_neg', 'minor issue_neg', 'minor issues_neg', 'two minor issues_neg', 'like_pos', 'perfect_pos'])
My f-in-law asked me to find him a new microwave capable of softening ice cream ~ his old unit had the number read-out die.The new unit works fine; having to figure out new controls has been a challenge for this 91 yr. old (active) gentleman.HE likes the unit.The need to continually hit a reset button has been problematic.He is having a learning curve issue with re-heating food especially bread products.	set(['challenge_neg', 'fine_pos', 'like_pos', 'likes_pos', 'problematic_neg', 'works fine_pos', 'problem_neg', 'find_pos', 'old_pos', 'old_neg'])
my $20 mocha makes a better cup of espresso, no question there.	set(['better_neg', 'a better cup_neg', 'better_pos'])
Luckily, I also have a large kitchen with plenty of counter space, otherwise I would return it for that reason alone.	set(['would return it_neg', 'return_neg', 'wise_pos', 'Luckily_pos', 'large_pos'])
I should have read the description better.	set(['better_neg', 'should have read the description better_neg', 'better_pos'])
